###################B  #
# ##### ### # ####### #
# #   # ### # ####    #
# # # # ### # #### ####
# # # #     # ###  #  #
# # # ##### # ### ### #
#   #   #   #   #     #
# ##### # ##### ##### #
#             #   #   #
####### ##### ### # # #
###       #   #     ###
### ##### # ##### #####
###     # #   #     ###
### ### # ### ##### ###
#     # #     #       #
##### ### ##### ##### #
#     #               #
##### ######### #######
#A      #######       #
#######################
